11111111111111111111111111111111
11111111111111111111111111111111
11000000000000111000000000000011
11000000000000111000000000000011
11000000000000111000000000000011
11000000000000111000000000000011
11000022200000111000000222200011
11000022200000111000000222200011
11000022200000111000000222200011
11000011100000111000000111100011
11000011100000111000000111100011
11000011100000222000000111100011
11000011100000222000000111100011
11000011100000222000000111100011
11000011100000000000000111100011
11000011100000000000000111100011
11000011100000000000000111100011
11555511100000000000000111104011
