33333333333333333333333333333333
33333333333333333333333333333333
33333333333333333333333333333333
10000001111111110000000000000005
10000001111111110000000000000005
10000001111111110000000000000005
00000001111111110000000000000005
00000001111111110000000111111111
40000001111111110000000111111111
00000001111111110000000111111111
00000000000000000000000111111111
10000000000000000000000111111111
10000000000000000000000111111111
10000000000000000000000111111111
10000000000000000000000111111111
33333333333333333333333333333333
33333333333333333333333333333333
33333333333333333333333333333333
