11111111111111111111111111111111
11111111111111111111111111111111
11111111111111111111111111111111
11100000000000000000000000000000
11100000000000000000000000000000
11100000000000000000000000000004
11100000000000000000000000000000
11100000000000000000000000000000
11100000222111111111111111111111
11100000222111111111111111111111
11100000222111111111111111111111
11100000111111111111111111111111
11100000111111111111111111111111
11100000111111111111111111111111
11100000111111111111111111111111
11100000111111111111111111111111
11100000111111111111111111111111
11155555111111111111111111111111
