11111111111111111111111111111111
11111111000000000000000000000000
11111110000000000000000000000000
11111100000000000000000000000000
11111000000000000000000000000004
11110000000000000000000000000000
11100000000000000000000000000000
11000000000000222222220000000000
11000000000000222222220000000001
11000000000000222222220000000001
11000000000000222222220000000001
11000000000000000000000000000005
11100000000000000000000000000005
11110000000000000000000000000005
11111000000000000000000000000005
11111100000000000000000000000005
11111110000000000000000000000005
11111111111111111111111111111111
