11111111111111111111111111111111
11000000000000000000000000000000
10000000000000000222000000000000
10000011110000000222000000000004
10000011110000000222000000000000
10000011110000000000000000000000
10000011110000000000000002220001
10000000000000000000000002220001
10000000000000000000000002220001
10000000000000000000000000000001
10000000000022200000000000000001
50000000000022200000000000000001
50000000000022200000000222220001
50000000000000000000000222220001
50000000000000000000000222220001
50000000000000000000000222220001
50000000000000000000000000000001
11111111111111111111111111111111
