11111111111111111111111111111111
11111111111111111111111111111111
11111111111111111111111111111111
11111111110000000000000000000000
11111111110000000000000000000000
11111111110000000000000000000004
11111111110000000000000000000000
11111111110000000000000000000000
11111111110000000000000000000000
50000000000000000001111111111111
50000000000000000001111111111111
50000000000000000001111111111111
50000000000000000001111111111111
50000000000000000001111111111111
50000000000000000001111111111111
50000000000000000001111111111111
11111111113333333331111111111111
11111111113333333331111111111111
