33100000000000000000000000000133
33100000000000000000000000000133
33100000000000000000000000000133
33100000000000000000000000000133
33100000000000000000000000000133
33100000022200000000222000000133
33100000022200000000222000000133
33100000022200000000222000000133
33100000000000000000000000000133
33100000000000000000000000000133
33100000000000000000000000000133
33100000000000000000000000000133
33100000000000000000000000000133
33111111100001000010000111111133
33100000000001000010000000000133
33100000000001000010000000000133
33100000000001000010000000000133
33155555555551004015555555555133
